15 15
2025 8 8 8 8 8 8 8 8 8 8 8 8 8 12 
1 0 0 0 0 0 0 0 0 0 0 0 0 0 4 
1 0 0 0 0 0 0 0 0 0 0 0 0 0 4 
1 0 0 0 0 0 2 0 0 0 0 0 0 0 4 
1 0 0 0 0 4 13 1 0 0 0 0 0 0 4 
1 0 0 0 2 6 5 3 2 2 0 0 0 0 4 
1 0 0 4 11 10 0 10 10 14 1 0 0 0 4 
1 0 0 0 8 12 5 9 8 8 0 0 0 0 4 
1 0 0 0 0 4 7 1 0 0 0 0 0 0 4 
1 0 0 0 0 0 8 0 0 0 0 0 0 0 4 
1 0 0 0 0 0 0 0 0 0 0 0 0 0 4 
1 0 0 0 0 0 0 0 0 0 0 0 0 0 4 
1 0 0 0 0 0 0 0 0 0 0 0 0 0 4 
1 0 0 0 0 0 0 0 0 0 0 0 0 0 4 
3 2 2 2 2 2 2 2 2 2 2 2 2 2 6 
