15 15
2025 8 8 8 8 8 8 8 8 8 8 8 8 8 12 
1 0 0 0 0 0 0 0 0 0 0 0 0 0 4 
1 0 0 0 0 0 0 0 0 0 0 0 0 0 4 
1 0 0 0 0 0 0 0 0 0 0 0 0 0 4 
1 0 0 0 0 0 0 0 0 0 0 0 0 0 4 
1 0 0 0 0 0 0 0 0 0 0 0 0 0 4 
1 0 0 0 0 0 0 0 0 0 0 0 0 0 4 
1 0 0 0 0 0 0 0 0 0 0 0 0 0 4 
1 0 0 0 0 0 0 0 0 0 0 0 0 0 4 
1 0 0 0 0 0 0 0 0 0 0 0 0 0 4 
1 0 0 0 0 0 0 0 0 0 0 0 0 0 4 
1 0 0 0 0 0 0 0 0 0 0 0 0 0 4 
1 0 0 0 0 0 0 0 0 0 0 0 0 0 4 
1 0 0 0 0 0 0 0 0 0 0 0 0 0 4 
3 2 2 2 2 2 2 2 2 2 2 2 2 2 6 
