15 15
9 10 8 8 8 10 8 14 13 13 13 9 8 8 12 
5 9 6 1 2 1192 2 10 0 1184 0 6 5 1189 5 
1 0 1194 4 9 2 12 9 0 1184 6 13 1 0 4 
1189 5 13 5 7 11 0 0 6 1 8 4 5 3 1188 
5 7 1 4 13 1193 0 1184 8 0 1186 4 3 8 4 
1 10 4 5 1 2 2 2 0 0 10 0 8 4 7 
1 8 1190 5 1189 13 9 12 5 3 8 0 0 2 12 
1 0 14 7 3 0 6 1 0 1194 4 1 2 10 4 
1189 7 9 8 8 2 12 5 5 9 6 3 8 10 1188 
3 12 5 5 3 12 1185 6 1187 0 1194 10 1184 8 4 
13 5 3 4 9 0 2 12 11 0 8 10 6 5 5 
1187 2 8 0 1188 1 14 1 12 3 16 14 9 2 4 
9 10 0 0 4 3 10 4 1 10 0 14 1 14 5 
1 10 4 7 5 11 8 4 1 12 3 1192 2 12 1189 
3 10 1186 14 3 10 2 2 1190 7 11 2 10 2 6 
